
                               #   #    #              #          #
                   #            #  ##   ##             ##   ########
      ###############           ##  #   #####           ##       ##
           ## ##                # #######               #        ##
           ## ##                    ## #   #             #       ##
       #   ## ##   #          #   # #   #####         #####      ##
       ##############          ## # # #   ##            ##  #######
       ##  ## ##  ##           # # ##### ##             ##  ##   #
       ##  ## ##  ##             # # ##  #              ##  ##
       ##  ## ######            #  # ##  ##             ##  ##
       ## ##   #####          ###  # ########           ##  ##
       ###        ##           ##  # ##  ##             ## ###
       ##         ##           ## ## ##  ##             ### ##     #
       #############           ## #  ##  ##            ###  ##     #
       ##         ##           ## # ### ###             #   #########
       #          #            # #   #   #                   #######

